8,5
1,3
X X X 0 0
X X 0 0 0
X X 0 X 0
X X 0 X T
0 0 0 P 0
0 0 0 X X
0 D 0 0 X
